20
1111111111
0000000000
0000001000
1000011111
1110000000
1000001000
0001111000
0000000000
1110001110
1000001000
